apt-get install net-tools (устарело) - пример установки доп программ
apt-get remove resolvconf () - пример удаления модулей
apе-get update

man - мануал по командам
sudo - запуск с root правами
su - смена пользователя
uname - инфо о linux
hostname - имя ПК
dpkg -l - вывод установленый пакетов (Debian)
runlevel - текущий уровень выполнения
init - переключение между уровнями выполнения
poweroff - выключение после остановки всех процессов
shutdown - контролируемое завершение работы (-k time -предупреждающее сообщение, -c, -r, -h )
halt - полная остановка процессов без отключения питания (-n не производить синхронизацию)
reboot - перезагрузка
clear - очистка терминала
echo - вывод на основной поток вывода
printf - форматированный вывод
read - ввод данных
history - история вводимых команд
export - создание временной переменной
alias - создание псевдонима
unalias - отключение псевдонима
source - перезагрузка переменных окружения
date +%Y - вывод текущей даты
bash - выполнение bash-скрипта (-v, -x -отладка)
python3 - выполнение pytрon скрипта
expr - рассчитать значение 


pwd - текущая директория
cd - смена директории
mkdir - создание директории
ln - создание ссылки
touch - создание пустых файлов
mknod - создание блочных и символьных устройств в /dev
ls - содержимое директории
dir - содержимое директории
file - определяет тип файла
stat - подробная информация о файле
cp - копирование
mv - перемещение
rmdir - удаление каталога
rm - удаление
cat - вывод всего содержимого файла
less - вывод содержимого файла по частям
more - чтение конца файла
head - первые строки файла
tail - последние строки файла
lsblk - список блочных устройств
lspci - список подключенных PCI-устройств
lsusb - список подключенных USB-устройств
dmesg - диагностические сообщения ядра
lshw - комплексный отчет по оборудованию (apt-get)
blkid - инфо о блочных устройствах
findmnt - список смонтированных файловых систем
df (disk free) - отчет об использовании фс
du (disk usage) - объем использованного места на диске
mount - монтирование устройства - необходимо перед использованием
unmount - отмонтирование
tar - работа с архивами
gzip - сжатие архива
updatedb - обновление БД для поиска файлов
locate - поиск файлов
whereis - поиск исполняемых файлов, исходные кода
find - поиск с помощью регулярных выражений

wc (word count) - подсчет значений (с - байты, l-строки, w-слова, m-символы, -L-длина самой длинной строка
nl - нумерация строк
cut - выделение колонки из файла (-f-номер, -d-символ разделителя)
sort - сортирует текст (f-игнорирование регистра, -r обратный, -u-уникальность, -t-разделитель, сортировка по полю, -n по числу
uniq - отслеживает повторяющиеся строки (-d -вывод только повторяющихся строк, -с -вывод кол-ва повторений
diff - сравнивает два файла и указывает на различия (< - показывает отличия первого, > - второго)
aspell - проверка орфографии
grep (global regular expression print) - поиск подстроки по регулярному выражению (-v НЕ; -c-кол-во строк; -i-регист; -n-номер стоки; -A num строки до; -B num строки после)
sed (stream editor) - потоковый текстовый редактор (s'/find/change/g')
pr (print) - вывод содержимого файла через форматирование (колонки)
tr (translate) - замена символов
frm - форматирование вывода (кол-во символов в строке)

ps - список запущенных процессов (a-все, u-user, x)
pstree - демонстрирует древовидную структуру процессов
top - процессы в реальном времени
free - инфо об использованной памяти
lscpu - инфо о процессорах
mpstat - инфо об использовании процессора (-p конкретные процесс)
kill - отправка сигналов процессу (-l - список сигналов, %n-номер проц)
nice - изменяет NI при запуске программы
renice - изменяет NI для запущенны процессов
command & - запуск команды в фоновом режиме
jobs - список фоновых команд и команд в фоновом режиме
bg - продолжает работу команды в фоне
fg - продолжает работу в обычном режиме
yes - отправляет бесконечный цикл вывода y
atq - просмотр ожидающих заданий
service - управление службами
systemctl - управление службами systemd (list-units, status, start, stop, restart, enable, disable, get-default, set-default, isolate, emergency)
crontab - создание пользовательских повторяющихся заданий cron (-e, -l)

wget - получение файлов по сети через протоколы http, https, ftp
ssh - соединение по протоколу ssh с другим компьютером
scp - копирование файлов через ssh
host - информация об узле по его ip
rpm - работа с .rpm пакетами (RedHat)
alien - преобразование .deb .rmp


